adns	meta-tizen-common-base/recipes-support/adns
ail	meta-tizen-common-base/recipes-application-framework/ail
alarm-manager	meta-tizen-common-base/recipes-application-framework/alarm-manager
alsa-scenario-0.2	meta-tizen-common-base/recipes-multimedia/alsa-scenario
app-checker	meta-tizen-common-base/recipes-application-framework/app-checker
appcore-agent	meta-tizen-common-base/recipes-application-framework/appcore-agent
app-core	meta-tizen-common-base/recipes-application-framework/app-core
application	meta-tizen-common-base/recipes-application-framework/capi-appfw-application
app-manager	meta-tizen-common-base/recipes-application-framework/capi-appfw-app-manager
app-svc	meta-tizen-common-base/recipes-application-framework/app-svc
audio-session-manager	meta-tizen-common-base/recipes-multimedia/audio-session-manager
aul-1	meta-tizen-common-base/recipes-application-framework/aul
automotive-message-broker	meta-tizen-ivi/recipes-extended/automotive-message-broker
avsystem	meta-tizen-common-base/recipes-multimedia/avsystem
badge	meta-tizen-common-base/recipes-application-framework/badge
bluetooth-frwk	meta-tizen-common-base/recipes-connectivity/bluetooth-frwk
bluetooth	meta-tizen-common-base/recipes-application-framework/capi-network-bluetooth
bluetooth-tools	meta-tizen-common-base/recipes-connectivity/bluetooth-tools
bundle	meta-tizen-common-base/recipes-connectivity/bundle
buxton	meta-tizen-common-base/recipes-security/buxton
ca-certificates-tizen	meta-tizen-common-base/recipes-support/ca-certificates-tizen
calendar-service	meta-tizen-common-base/recipes-social/calendar-service
com-core	meta-tizen-common-base/recipes-application-framework/libcom-core
common-api-dbus-runtime	meta-tizen-ivi/recipes-automotive/CommonAPI-DBus
common-api-runtime	meta-tizen-ivi/recipes-automotive/CommonAPI
common-crosswalk-suite	meta-tizen-common-devtools/recipes-devtools/common-crosswalk-suite
common-graphics-suite	meta-tizen-common-devtools/recipes-devtools/common-graphics-suite
common	meta-tizen-common-base/recipes-application-framework/capi-base-common
common-multimedia-suite	meta-tizen-common-devtools/recipes-devtools/common-multimedia-suite
common-sanity-suite	meta-tizen-common-devtools/recipes-devtools/common-sanity-suite
common-suite-launcher	meta-tizen-common-devtools/recipes-devtools/common-suite-launcher
connection	meta-tizen-common-base/recipes-application-framework/capi-network-connection
contacts-service	meta-tizen-common-base/recipes-social/contacts-service
crosswalk	meta-tizen-common-share/recipes-crosswalk/crosswalk
cynara	meta-tizen-common-base/recipes-security/cynara
dbus-python	meta-tizen-common-base/recipes-core/dbus-python
default-ac-domains	meta-tizen-common-base/recipes-security/default-ac-domains
desktop-file-utils	meta-tizen-common-base/recipes-core/desktop-file-utils
desktop-skin	meta-tizen-common-demo/recipes-multimedia/desktop-skin
device	meta-tizen-common-base/recipes-application-framework/capi-system-device
dlog	meta-tizen-common-base/recipes-core/dlog
dlt-daemon	meta-tizen-ivi/recipes-extended/dlt
download-provider	meta-tizen-common-base/recipes-connectivity/download-provider
drm-client	meta-tizen-common-base/recipes-graphics/drm-client
dukgenerator	meta-tizen-common-base/recipes-core/dukgenerator
ecryptfs-utils	meta-tizen-ivi/recipes-support-ivi/ecryptfs-utils
edbus	meta-tizen-common-share/recipes-efl/edbus
efl	meta-tizen-common-share/recipes-efl/efl
efl-theme-tizen	meta-tizen-common-share/recipes-efl/efl-theme-tizen-hd
elementary	meta-tizen-common-share/recipes-efl/elementary
evolution-data-server	meta-tizen-common-base/recipes-social/evolution-data-server
favorites	meta-tizen-common-base/recipes-application-framework/capi-web-favorites
fdupes	meta-tizen-common-base/recipes-devtools/fdupes
festival	meta-tizen-common-base/recipes-extended/festival
gcr	meta-tizen-common-base/recipes-security/gcr
genivi-audio-manager	meta-tizen-ivi/recipes-multimedia/genivi-audio-manager
gobject-introspection	meta-tizen-common-base/recipes-devtools/gobject-introspection
gpg2	meta-tizen-common-base/recipes-security/gpg2
gsignond	meta-tizen-common-base/recipes-security/gsignond
gsignond-plugin-oauth	meta-tizen-common-base/recipes-security/gsignond-plugin-oauth
gsignond-plugin-sasl	meta-tizen-common-base/recipes-security/gsignond-plugin-sasl
GUPnP-AV	meta-tizen-ivi/recipes-connectivity/gupnp-av
GUPnP-DLNA	meta-tizen-ivi/recipes-connectivity/gupnp-dlna
GUPnP	meta-tizen-ivi/recipes-connectivity/gupnp
heynoti	meta-tizen-common-base/recipes-application-framework/heynoti
hwdata	meta-tizen-common-base/recipes-core/hwdata
ibus-hangul	meta-tizen-ivi/recipes-graphics/ibus-hangul
ibus-libpinyin	meta-tizen-ivi/recipes-graphics/ibus-libpinyin
ibus	meta-tizen-ivi/recipes-graphics/ibus
ico-uxf-device-input-controller	meta-tizen-ivi/recipes-ico/ico-uxf-device-input-controller
ico-uxf-homescreen	meta-tizen-ivi/recipes-ico/ico-uxf-homescreen
ico-uxf-homescreen-sample-apps	meta-tizen-ivi/recipes-ico/ico-uxf-homescreen-sample-apps
ico-uxf-utilities	meta-tizen-ivi/recipes-ico/ico-uxf-utilities
ico-uxf-weston-plugin	meta-tizen-ivi/recipes-ico/ico-uxf-weston-plugin
ico-vic-amb-plugin	meta-tizen-ivi/recipes-ico/ico-vic-amb-plugin
ico-vic-carsimulator	meta-tizen-ivi/recipes-ico/ico-vic-carsimulator
image-util	meta-tizen-common-base/recipes-application-framework/capi-media-image-util
iniparser	meta-tizen-common-base/recipes-core/iniparser
ivi-sanity-suite	meta-tizen-common-devtools/recipes-devtools/ivi-sanity-suite
keyutils	meta-tizen-ivi/recipes-support-ivi/keyutils
lemolo	meta-tizen-common-share/recipes-efl/lemolo
libaccounts-svc	meta-tizen-common-base/recipes-social/libaccounts-svc
libav	meta-tizen-common-base/recipes-multimedia/libav
libbullet	meta-tizen-common-base/recipes-core/bullet
libcryptsvc	meta-tizen-common-base/recipes-core/libcryptsvc
libdevice-node	meta-tizen-common-base/recipes-core/libdevice-node
libdrm	meta-tizen-common-base/recipes-graphics/libdrm
libgee	meta-tizen-ivi/recipes-devtools/libgee
libgsasl	meta-tizen-common-base/recipes-security/libgsasl
libgsignon-glib	meta-tizen-common-base/recipes-security/libgsignon-glib
libhangul	meta-tizen-ivi/recipes-graphics/libhangul
libICE	meta-tizen-common-share/recipes-devtools/libICE
libiri	meta-tizen-common-base/recipes-core/libiri
libmedia-service	meta-tizen-common-base/recipes-multimedia/libmedia-service
libmedia-thumbnail	meta-tizen-common-base/recipes-multimedia/libmedia-thumbnail
libmm-common	meta-tizen-common-base/recipes-multimedia/libmm-common
libmm-fileinfo	meta-tizen-common-base/recipes-multimedia/libmm-fileinfo
libmm-log	meta-tizen-common-base/recipes-multimedia/libmm-log
libmm-player	meta-tizen-common-base/recipes-multimedia/libmm-player
libmm-session	meta-tizen-common-base/recipes-multimedia/libmm-session
libmm-sound	meta-tizen-common-base/recipes-multimedia/libmm-sound
libmm-ta	meta-tizen-common-base/recipes-multimedia/libmm-ta
libmm-utility	meta-tizen-common-base/recipes-multimedia/libmm-utility
libnet-client	meta-tizen-common-base/recipes-connectivity/libnet-client
libpinyin	meta-tizen-ivi/recipes-graphics/libpinyin
libprivilege-control	meta-tizen-common-base/recipes-security/libprivilege-control
librua	meta-tizen-common-base/recipes-application-framework/librua
libsecret	meta-tizen-common-base/recipes-security/libsecret
libsf-common	meta-tizen-common-base/recipes-core/libsf-common
libslp-db-util	meta-tizen-common-base/recipes-applications/libslp-db-util
libslp-location	meta-tizen-common-base/recipes-applications/libslp-location
libslp-memo	meta-tizen-common-base/recipes-applications/libslp-memo
libslp-sensor	meta-tizen-common-base/recipes-core/sensor
libSM	meta-tizen-common-share/recipes-devtools/libSM
libsvi	meta-tizen-common-base/recipes-core/libfeedback
libtapi-legacy	meta-tizen-common-base/recipes-telephony/libtapi
libtapi	meta-tizen-common-base/recipes-telephony/libtapi3
libtbm	meta-tizen-ivi/recipes-graphics/libtbm
libwbxml2	meta-tizen-common-base/recipes-core/libwbxml2
libwebsockets	meta-tizen-common-base/recipes-webframework/libwebsockets
libwifi-direct	meta-tizen-common-base/recipes-connectivity/libwifi-direct
libxml2	meta-tizen-common-base/recipes-core/libxml2
location-manager	meta-tizen-common-base/recipes-application-framework/capi-location-manager
lua	meta-tizen-common-base/recipes-devtools/lua
media-content	meta-tizen-common-base/recipes-application-framework/capi-content-media-content
media-server	meta-tizen-common-base/recipes-multimedia/media-server
message-port-dbus	meta-tizen-common-base/recipes-application-framework/message-port
meta-generic	meta-tizen-common-base/recipes-devtools/meta-generic
meta	meta-tizen-common-base/recipes-devtools/meta-common
mobile-broadband-provider-info	meta-tizen-common-share/recipes-connectivity/mobile-broadband-provider-info
Modello_AMBSimulator	meta-tizen-ivi/recipes-modello/Modello-AMBSimulator
Modello_Appmanager	meta-tizen-ivi/recipes-modello/Modello-Appmanager
Modello_Common	meta-tizen-ivi/recipes-modello/Modello-Common
Modello_Dashboard	meta-tizen-ivi/recipes-modello/Modello-Dashboard
Modello_Homescreen	meta-tizen-ivi/recipes-modello/Modello-Homescreen
Modello_Hvac	meta-tizen-ivi/recipes-modello/Modello-Hvac
Modello_Installer	meta-tizen-ivi/recipes-modello/Modello-Installer
Modello_Multimediaplayer	meta-tizen-ivi/recipes-modello/Modello-Multimediaplayer
Modello_Nav	meta-tizen-ivi/recipes-modello/Modello-Nav
Modello_Phone	meta-tizen-ivi/recipes-modello/Modello-Phone
Modello_SDL	meta-tizen-ivi/recipes-modello/Modello-SDL
msg-service	meta-tizen-common-base/recipes-messaging/msg-service
murphy	meta-tizen-common-share/recipes-core/murphy
neardal	meta-tizen-common-base/recipes-connectivity/neardal
net-config	meta-tizen-common-base/recipes-connectivity/net-config
nfc-manager-neard	meta-tizen-common-base/recipes-connectivity/nfc-manager-neard
nfc	meta-tizen-common-base/recipes-application-framework/capi-network-nfc
node-startup-controller	meta-tizen-ivi/recipes-automotive/node-startup-controller
notification	meta-tizen-ivi/recipes-framework/notification
ofono	meta-tizen-common-share/recipes-connectivity/ofono
oma-ds-agent	meta-tizen-common-base/recipes-core/oma-ds-agent
opencore-amr	meta-tizen-common-base/recipes-connectivity/opencore-amr
package-manager	meta-tizen-common-base/recipes-application-framework/capi-appfw-package-manager
pam	meta-tizen-common-base/recipes-extended/pam
phoned	meta-tizen-ivi/recipes-modello/phoned
pims-ipc	meta-tizen-common-base/recipes-social/pims-ipc
pkgmgr-info	meta-tizen-common-base/recipes-application-framework/pkgmgr-info
power	meta-tizen-common-base/recipes-application-framework/capi-system-power
privacy-manager	meta-tizen-common-base/recipes-security/privacy-manager-server
pulseaudio	meta-tizen-common-base/recipes-multimedia/pulseaudio
pulseaudio-module-murphy-ivi	meta-tizen-ivi/recipes-multimedia/pulseaudio-module-murphy-ivi
python-requests	meta-tizen-common-devtools/recipes-devtools/python-requests
python-setuptools	meta-tizen-common-base/recipes-devtools/python-setuptools
rpm	meta-tizen-common-base/recipes-devtools/rpm
runtime-info	meta-tizen-common-base/recipes-application-framework/capi-system-runtime-info
rygel	meta-tizen-ivi/recipes-multimedia/rygel
secure-storage	meta-tizen-common-base/recipes-security/secure-storage
security-manager	meta-tizen-common-base/recipes-security/security-manager
security-server	meta-tizen-common-base/recipes-security/security-server
sensor	meta-tizen-common-base/recipes-application-framework/capi-system-sensor
slp-pkgmgr	meta-tizen-common-base/recipes-application-framework/pkgmgr
smack	meta-tizen-common-base/recipes-security/smack
sound-manager	meta-tizen-common-base/recipes-application-framework/capi-media-sound-manager
sphinxbase	meta-tizen-common-base/recipes-extended//sphinxbase
status	meta-tizen-common-base/recipes-application-framework/status
sync-agent	meta-tizen-common-base/recipes-core/sync-agent
syspopup	meta-tizen-common-base/recipes-application-framework/syspopup
systemd	meta-tizen-common-base/recipes-core/systemd
system-info	meta-tizen-common-base/recipes-application-framework/capi-system-info
system-server	meta-tizen-common-base/recipes-core/system-server
system-settings	meta-tizen-common-base/recipes-application-framework/capi-system-system-settings
tdb	meta-tizen-common-base/recipes-devtools/tdb
testkit-lite	meta-tizen-common-devtools/recipes-devtools/testkit-lite
testkit-stub	meta-tizen-common-devtools/recipes-devtools/testkit-stub
tethering	meta-tizen-common-base/recipes-application-framework/capi-network-tethering
tiff	meta-tizen-common-base/recipes-multimedia/tiff
tizen-extensions-crosswalk	meta-tizen-common-share/recipes-crosswalk/tizen-extensions-crosswalk
tizen-platform-config	meta-tizen-common-base/recipes-core/tizen-platform-config
tizen-platform-wrapper	meta-tizen-common-base/recipes-core/tizen-platform-wrapper
udev-rules	meta-tizen-common-base/recipes-core/udev-rules
update-desktop-files	meta-tizen-common-base/recipes-application-framework/update-desktop-files
url-download	meta-tizen-common-base/recipes-application-framework/capi-web-url-download
uthash	meta-tizen-common-base/recipes-core/uthash
vala	meta-tizen-common-base/recipes-devtools/vala
vconf-buxton	meta-tizen-common-base/recipes-application-framework/vconf-buxton
vconf-internal-keys	meta-tizen-common-base/recipes-application-framework/vconf-internal-keys
wav-player	meta-tizen-common-base/recipes-application-framework/capi-media-wav-player
wayland-fits	meta-tizen-common-devtools/recipes-devtools/wayland-fits-master
wayland-ivi-extension	meta-tizen-ivi/recipes-graphics/genivi-shell
weekeyboard	meta-tizen-common-base/recipes-graphics/weekeyboard
weston-common	meta-tizen-common-demo/recipes-graphics/weston-common
weston-ivi	meta-tizen-ivi/recipes-graphics/weston-ivi
weston-ivi-shell	meta-tizen-ivi/recipes-graphics/weston-ivi-shell
weston	meta-tizen-common-base/recipes-graphics/weston
wifi	meta-tizen-common-base/recipes-application-framework/capi-network-wifi
wrt-widgets	meta-tizen-common-demo/recipes-webframework/wrt-widgets
xdgmime	meta-tizen-common-base/recipes-core/xdgmime
xmlsec1	meta-tizen-common-base/recipes-security/xmlsec1
xtrans	meta-tizen-common-share/recipes-devtools/xtrans
